1111111111
1C0011E0C1
1110010001
1C00G001P1
1111111111
