11111111111111111111111111
1C0C0C0C0C0C11C0C0C0C0C0C1
101111C111101101111C111101
1C111101111C11C111101111C1
101111C111101101111C111101
1C0C0C0C0C0C00C0C0C0C0C0C1
101111C101111111101C111101
1C0C0C01000011000010C0C0C1
111111C111101101111C111111
11111101000000000010111111
111111C101110011101C111111
1C0C0C0001RG0E0B1000C0C0C1
111111C101111111101C111111
1111110100000P000010111111
111111C101111111101C111111
1C0C0C0C0C0C11C0C0C0C0C0C1
101111C111101101111C111101
1C0C110C0C0C00C0C0C011C0C1
111011C101111111101C110111
1C0C0C010C0C11C0C010C0C0C1
10111111111011011111111101
1C0C0C0C0C0C00C0C0C0C0C0C1
11111111111111111111111111
