1111111
1000001
100P001
1000001
10CE001
1111111
