NO ./textures/stonewall.xpm
EA ./textures/stonewall.xpm
WE ./textures/stonewall_dark.xpm
SO ./textures/stonewall_dark.xpm

F 102,68,0
C 102,0,68

111111111111111111111
1E0000000000000000001
1100100000011111d1111
100111100001   101
100000100001   101
100d00d00001   101
100111100001   101
1000000000011111d1111111111111111111
100000001000000000000000000000000001
100000010000000000000000000000000001
100000100001d11111111111111111111111
11111111111101
           101
           101
           101
           101
111111111111d11111111
100000000000000000001
110010000000000011111d1111
10010000000000001   101
10000010000000001   101
100d0000000100001   101
10010000000100001   101
1000000000011111d1111111111111111111
100010001000000000000000000000000001
100000010000000000000000000000000001
100000100001d11111111111111111111111
11111111111111
