NO ./textures/stonewall.xpm
EA ./textures/stonewall.xpm
WE ./textures/stonewall_dark.xpm
SO ./textures/stonewall_dark.xpm

F 102,68,0
C 102,0,68


1111111111111111111111
1E00000000000000000001
1100100000011111111111
100111100001
100000100001
100000d00001
1001d1100001
100000000001
100000001001
1000x0010001
100000100001
111111111111
