NO ./textures/NO_256.xpm
WE ./textures/WE_256.xpm     
EA ./textures/EA_256.xpm
SO ./textures/SO_256.xpm

                F 0,100,1
      C 105,30,200      

                111111111111
          1111111E0000000001
 11    11100110000011110111
1001111000011111111   101
10000010000000001     101
1001001000011111111111101
1001111000010000000000001
1000000000010111111111111
10000000000001
10000001000111
100000000001
111111111111
